0 0 0 0 0 0 0 0 0 0 0 0 0 0 0 0 0 0 0 0 0 0 0 0 0 0 0 0 0 0 0 0 0 0 0 0 0 0 0 0 0 0 0 0 0 0 0 0 0 0 
0 0 0 0 0 0 0 0 0 0 0 0 0 0 0 0 0 0 0 0 0 0 0 0 0 0 0 0 0 0 0 0 0 0 0 0 0 0 0 0 0 0 0 0 0 0 0 0 0 0 
0 0 0 0 0 0 0 0 0 0 0 0 0 0 0 0 0 0 0 0 0 0 0 0 0 0 0 0 0 0 0 0 0 0 0 0 0 0 0 0 0 0 0 0 0 0 0 0 0 0 
0 0 0 0 0 0 0 0 0 0 0 0 0 0 0 0 0 0 0 0 0 0 0 0 0 0 0 0 0 0 0 0 0 0 0 0 0 0 0 0 0 0 0 0 0 0 0 0 0 0 
0 0 0 0 0 0 0 0 0 0 0 0 0 0 0 0 0 0 0 0 0 0 0 0 0 0 0 0 0 0 0 0 0 0 0 0 0 0 0 0 0 0 0 0 0 0 0 0 0 0 
0 0 0 0 0 0 0 0 0 0 0 0 0 0 0 0 0 0 0 0 0 0 0 0 0 0 0 0 0 0 0 0 0 0 0 0 0 0 0 0 0 0 0 0 0 0 0 0 0 0 
0 0 0 0 0 0 0 0 0 0 0 0 0 0 0 0 0 0 0 0 0 0 0 0 0 0 0 0 0 0 0 0 0 0 0 0 0 0 0 0 0 0 0 0 0 0 0 0 0 0 
0 0 0 0 0 0 0 0 0 0 0 0 0 0 0 0 0 0 0 0 0 0 0 0 0 0 0 0 0 0 0 0 0 0 0 0 0 0 0 0 0 0 0 0 0 0 0 0 0 0 
0 0 0 0 0 0 0 0 0 0 0 0 0 0 0 0 0 0 0 0 0 0 0 0 0 0 0 0 0 0 0 0 0 0 0 0 0 0 0 0 0 0 0 0 0 0 0 0 0 0 
0 0 0 0 0 0 0 0 0 0 0 0 0 0 0 0 0 0 0 0 0 0 0 0 0 0 0 0 0 0 0 0 0 0 0 0 0 0 0 0 0 0 0 0 0 0 0 0 0 0 
0 0 0 0 0 0 0 0 0 0 0 0 0 0 0 0 0 0 0 0 0 0 0 0 0 0 0 0 0 0 0 0 0 0 0 0 0 0 0 0 0 0 0 0 0 0 0 0 0 0 
0 0 0 0 0 0 0 0 0 0 0 0 0 0 0 0 0 0 0 0 0 0 0 0 0 0 0 0 0 0 0 0 0 0 0 0 0 0 0 0 0 0 0 0 0 0 0 0 0 0 
0 0 0 0 0 0 0 0 0 0 0 0 0 0 0 0 0 0 0 0 0 0 0 0 0 0 0 0 0 0 0 0 0 0 0 0 0 0 0 0 0 0 0 0 0 0 0 0 0 0 
0 0 0 0 0 0 0 0 0 0 0 0 0 0 0 0 0 0 0 0 0 0 0 0 0 0 0 0 0 0 0 0 0 0 0 0 0 0 0 0 0 0 0 0 0 0 0 0 0 0 
0 0 0 0 0 0 0 0 0 0 0 0 0 0 0 0 0 0 0 0 0 0 0 0 0 0 0 0 0 0 0 0 0 0 0 0 0 0 0 0 0 0 0 0 0 0 0 0 0 0 
0 0 0 0 0 0 0 0 0 0 0 0 0 0 0 0 0 0 0 0 0 0 0 0 0 0 0 0 0 0 0 0 0 0 0 0 0 0 0 0 0 0 0 0 0 0 0 0 0 0 
0 0 0 0 0 0 0 0 0 0 0 0 0 0 0 0 0 0 0 0 0 0 0 0 0 0 0 0 0 0 0 0 0 0 0 0 0 0 0 0 0 0 0 0 0 0 0 0 0 0 
0 0 0 0 0 0 0 0 0 0 297 299 297 299 224 228 297 299 297 299 297 299 297 299 297 299 318 311 323 311 319 311 323 311 318 297 298 298 298 298 298 0 0 0 0 0 0 0 0 0 
0 0 0 0 0 0 0 0 0 0 298 300 217 221 225 229 298 300 298 300 298 300 298 300 298 300 285 311 324 311 319 311 324 311 285 298 298 298 298 298 298 0 0 0 0 0 0 0 0 0 
0 0 0 0 0 0 0 0 0 0 297 299 218 222 226 230 297 299 240 242 244 299 297 299 297 299 286 311 323 311 319 311 323 311 286 297 298 298 298 298 298 0 0 0 0 0 0 0 0 0 
0 0 0 0 0 0 0 0 0 0 298 300 219 223 227 231 298 300 241 243 245 300 300 300 298 300 318 311 324 311 319 311 324 311 318 298 298 298 298 298 298 0 0 0 0 0 0 0 0 0 
0 0 0 0 0 0 0 0 0 0 297 299 297 299 297 299 300 300 300 300 300 300 300 300 297 299 318 311 323 311 319 294 323 311 318 298 298 298 298 298 298 0 0 0 0 0 0 0 0 0 
0 0 0 0 0 0 0 0 0 0 300 300 300 300 300 300 300 300 300 300 300 300 300 300 298 300 318 311 324 311 319 311 324 311 318 298 298 298 298 298 298 0 0 0 0 0 0 0 0 0 
0 0 0 0 0 0 0 0 0 0 300 300 300 300 300 300 300 300 300 300 300 300 300 300 300 299 318 311 323 311 319 311 323 311 318 298 298 298 298 298 298 0 0 0 0 0 0 0 0 0 
0 0 0 0 0 0 0 0 0 0 300 300 300 300 300 300 300 300 300 300 300 300 300 300 300 300 318 311 324 311 319 311 324 311 318 298 298 298 298 298 298 0 0 0 0 0 0 0 0 0 
0 0 0 0 0 0 0 0 0 0 298 298 298 298 300 300 300 300 300 300 300 300 300 300 300 300 318 311 323 311 319 311 323 311 318 298 298 298 298 298 298 0 0 0 0 0 0 0 0 0 
0 0 0 0 0 0 0 0 0 0 312 312 312 312 312 312 312 312 312 312 312 312 312 312 312 312 312 311 324 311 319 311 324 311 316 316 316 316 316 316 316 0 0 0 0 0 0 0 0 0 
0 0 0 0 0 0 0 0 0 0 311 311 311 311 311 281 311 311 311 311 311 311 311 311 311 325 328 311 311 311 311 311 311 311 325 328 311 311 311 311 311 0 0 0 0 0 0 0 0 0 
0 0 0 0 0 0 0 0 0 0 295 296 295 296 295 296 295 296 295 296 295 296 295 296 311 326 329 311 311 311 311 311 311 311 326 329 295 296 295 296 311 0 0 0 0 0 0 0 0 0 
0 0 0 0 0 0 0 0 0 0 281 281 281 281 281 281 281 281 281 281 281 281 281 281 281 326 329 311 311 311 311 311 311 311 326 329 311 311 311 311 311 0 0 0 0 0 0 0 0 0 
0 0 0 0 0 0 0 0 0 0 311 311 311 281 311 311 311 294 265 311 311 294 311 311 311 326 329 311 311 311 311 311 311 311 326 329 311 311 311 311 311 0 0 0 0 0 0 0 0 0 
0 0 0 0 0 0 0 0 0 0 282 296 295 296 295 296 295 296 266 268 270 296 295 296 311 326 329 311 311 311 311 311 311 311 326 329 295 296 295 296 311 0 0 0 0 0 0 0 0 0 
0 0 0 0 0 0 0 0 0 0 283 311 311 311 311 311 311 294 311 269 271 294 311 311 311 327 330 311 311 311 311 311 311 311 325 328 311 311 311 311 311 0 0 0 0 0 0 0 0 0 
0 0 0 0 0 0 0 0 0 0 284 313 313 313 313 313 313 313 313 313 284 313 313 313 313 313 313 311 323 311 318 311 323 311 317 317 317 317 317 317 317 0 0 0 0 0 0 0 0 0 
0 0 0 0 0 0 0 0 0 0 117 124 131 137 144 298 151 159 167 175 183 298 298 298 298 298 320 311 324 311 318 311 324 311 318 298 298 298 298 298 298 0 0 0 0 0 0 0 0 0 
0 0 0 0 0 0 0 0 0 0 118 125 132 138 145 298 152 160 168 176 184 298 298 298 298 298 320 311 323 311 318 311 323 311 318 298 298 298 298 298 298 0 0 0 0 0 0 0 0 0 
0 0 0 0 0 0 0 0 0 0 119 126 133 139 146 298 153 161 169 177 185 298 298 298 298 298 320 311 324 311 318 311 324 311 318 298 298 298 298 298 298 0 0 0 0 0 0 0 0 0 
0 0 0 0 0 0 0 0 0 0 120 127 134 140 147 298 154 162 170 178 186 298 298 298 298 298 320 311 323 311 318 311 323 311 318 298 298 298 298 298 298 0 0 0 0 0 0 0 0 0 
0 0 0 0 0 0 0 0 0 0 121 128 135 141 148 298 155 163 171 179 187 298 298 298 298 298 320 311 324 311 318 311 324 311 318 298 298 298 298 298 298 0 0 0 0 0 0 0 0 0 
0 0 0 0 0 0 0 0 0 0 122 129 136 142 149 298 156 164 172 180 188 298 298 298 298 298 320 311 323 311 318 311 323 311 318 298 298 298 298 298 298 0 0 0 0 0 0 0 0 0 
0 0 0 0 0 0 0 0 0 0 123 130 138 143 150 298 157 165 173 181 189 298 298 298 298 298 320 311 324 311 318 311 324 311 318 298 298 240 242 244 298 0 0 0 0 0 0 0 0 0 
0 0 0 0 0 0 0 0 0 0 298 298 298 298 298 298 174 176 182 182 190 298 298 298 298 298 320 311 323 311 318 311 323 311 318 298 298 241 243 245 298 0 0 0 0 0 0 0 0 0 
0 0 0 0 0 0 0 0 0 0 298 298 298 298 298 298 298 298 298 298 298 298 298 298 298 298 320 311 324 311 318 311 324 311 318 298 298 298 298 298 298 0 0 0 0 0 0 0 0 0 
0 0 0 0 0 0 0 0 0 0 0 0 0 0 0 0 0 0 0 0 0 0 0 0 0 0 0 0 0 0 0 0 0 0 0 0 0 0 0 0 0 0 0 0 0 0 0 0 0 0 
0 0 0 0 0 0 0 0 0 0 0 0 0 0 0 0 0 0 0 0 0 0 0 0 0 0 0 0 0 0 0 0 0 0 0 0 0 0 0 0 0 0 0 0 0 0 0 0 0 0 
0 0 0 0 0 0 0 0 0 0 0 0 0 0 0 0 0 0 0 0 0 0 0 0 0 0 0 0 0 0 0 0 0 0 0 0 0 0 0 0 0 0 0 0 0 0 0 0 0 0 
0 0 0 0 0 0 0 0 0 0 0 0 0 0 0 0 0 0 0 0 0 0 0 0 0 0 0 0 0 0 0 0 0 0 0 0 0 0 0 0 0 0 0 0 0 0 0 0 0 0 
0 0 0 0 0 0 0 0 0 0 0 0 0 0 0 0 0 0 0 0 0 0 0 0 0 0 0 0 0 0 0 0 0 0 0 0 0 0 0 0 0 0 0 0 0 0 0 0 0 0 
0 0 0 0 0 0 0 0 0 0 0 0 0 0 0 0 0 0 0 0 0 0 0 0 0 0 0 0 0 0 0 0 0 0 0 0 0 0 0 0 0 0 0 0 0 0 0 0 0 0 
0 0 0 0 0 0 0 0 0 0 0 0 0 0 0 0 0 0 0 0 0 0 0 0 0 0 0 0 0 0 0 0 0 0 0 0 0 0 0 0 0 0 0 0 0 0 0 0 0 0 
