0 0 0 0 0 0 0 0 0 0 0 0 0 0 0 0 0 0 0 0 0 0 0 0 0 0 0 0 0 0 0 0 0 0 0 0 0 0 0 0 0 0 0 0 0 0 0 0 0 0 
0 0 0 0 0 0 0 0 0 0 0 0 0 0 0 0 0 0 0 0 0 0 0 0 0 0 0 0 0 0 0 0 0 0 0 0 0 0 0 0 0 0 0 0 0 0 0 0 0 0 
0 0 0 0 0 0 0 0 0 0 0 0 0 0 0 0 0 0 0 0 0 0 0 0 0 0 0 0 0 0 0 0 0 0 0 0 0 0 0 0 0 0 0 0 0 0 0 0 0 0 
0 0 0 0 0 0 0 0 0 0 0 0 0 0 0 0 0 0 0 0 0 0 0 0 0 0 0 0 0 0 0 0 0 0 0 0 0 0 0 0 0 0 0 0 0 0 0 0 0 0 
0 0 0 0 0 0 0 0 0 0 0 0 0 0 0 0 0 0 0 0 0 0 0 0 0 0 0 0 0 0 0 0 0 0 0 0 0 0 0 0 0 0 0 0 0 0 0 0 0 0 
0 0 0 0 0 0 0 0 0 0 175 175 175 175 175 175 175 175 175 175 175 175 175 175 175 175 175 175 175 175 175 175 175 175 175 175 175 175 175 175 0 0 0 0 0 0 0 0 0 0 
0 0 0 0 0 0 0 0 0 0 175 175 175 175 175 175 175 175 175 175 175 175 175 175 175 175 175 175 175 175 175 175 175 175 175 175 175 175 175 175 0 0 0 0 0 0 0 0 0 0 
0 0 0 0 0 0 0 0 0 0 175 175 175 175 175 175 175 175 175 175 175 175 175 175 175 175 175 175 175 175 175 175 175 175 175 175 175 175 175 175 0 0 0 0 0 0 0 0 0 0 
0 0 0 0 0 0 0 0 0 0 175 175 175 175 175 175 175 175 175 175 175 175 175 175 175 175 175 175 175 175 175 175 175 175 175 175 175 175 175 175 0 0 0 0 0 0 0 0 0 0 
0 0 0 0 0 0 0 0 0 0 175 175 175 175 175 175 175 175 175 175 175 175 175 175 175 175 175 175 175 175 175 175 175 175 175 175 175 175 175 175 0 0 0 0 0 0 0 0 0 0 
0 0 0 0 0 0 0 0 0 0 175 175 175 175 175 175 175 175 175 175 175 175 175 224 224 224 224 175 175 175 175 175 175 175 175 175 175 175 175 175 0 0 0 0 0 0 0 0 0 0 
0 0 0 0 0 0 0 0 0 0 175 175 175 175 175 175 175 175 175 175 175 175 175 224 220 221 224 175 175 175 175 175 175 175 175 175 175 175 175 175 0 0 0 0 0 0 0 0 0 0 
0 0 0 0 0 0 0 0 0 0 175 175 175 175 175 175 175 175 175 175 175 175 175 224 185 184 224 175 175 175 175 175 175 175 175 175 175 175 175 175 0 0 0 0 0 0 0 0 0 0 
0 0 0 0 0 0 0 0 0 0 175 175 175 175 175 175 175 175 175 175 175 175 175 224 185 184 224 175 175 175 175 175 175 175 175 175 175 175 175 175 0 0 0 0 0 0 0 0 0 0 
0 0 0 0 0 0 0 0 0 0 175 175 175 175 175 175 175 175 175 175 175 175 175 224 185 184 224 175 175 175 175 175 175 175 175 175 175 175 175 175 0 0 0 0 0 0 0 0 0 0 
0 0 0 0 0 0 0 0 0 0 175 175 175 175 175 175 175 175 175 175 175 175 175 224 185 184 224 175 175 175 175 175 175 175 175 175 175 175 175 175 0 0 0 0 0 0 0 0 0 0 
0 0 0 0 0 0 0 0 0 0 175 175 175 175 175 175 175 175 175 175 175 175 175 224 185 184 224 175 175 175 175 175 175 175 175 175 175 175 175 175 0 0 0 0 0 0 0 0 0 0 
0 0 0 0 0 0 0 0 0 0 175 175 175 175 175 175 175 175 175 175 175 175 175 224 185 184 224 175 175 175 175 175 175 175 175 175 175 175 175 175 0 0 0 0 0 0 0 0 0 0 
0 0 0 0 0 0 0 0 0 0 175 175 175 175 175 175 175 175 175 175 175 175 175 224 185 184 224 175 175 175 175 175 175 175 175 175 175 175 175 175 0 0 0 0 0 0 0 0 0 0 
0 0 0 0 0 0 0 0 0 0 175 175 175 175 175 175 175 175 175 175 175 175 175 224 185 184 224 175 175 175 175 175 175 175 175 175 175 175 175 175 0 0 0 0 0 0 0 0 0 0 
0 0 0 0 0 0 0 0 0 0 175 175 175 175 175 175 175 175 175 175 175 175 175 224 185 184 224 175 175 175 175 175 175 175 175 175 175 175 175 175 0 0 0 0 0 0 0 0 0 0 
0 0 0 0 0 0 0 0 0 0 175 175 175 175 175 175 175 175 175 175 175 175 175 224 185 184 224 175 175 175 175 175 175 176 177 175 175 175 175 175 0 0 0 0 0 0 0 0 0 0 
0 0 0 0 0 0 0 0 0 0 175 175 175 175 175 175 175 175 175 175 175 175 175 224 185 184 224 175 175 175 175 175 175 178 179 175 175 175 175 175 0 0 0 0 0 0 0 0 0 0 
0 0 0 0 0 0 0 0 0 0 175 175 175 175 175 175 175 175 175 175 175 175 175 224 185 184 224 175 175 175 175 175 175 224 224 175 175 175 175 175 0 0 0 0 0 0 0 0 0 0 
0 0 0 0 0 0 0 0 0 0 224 224 224 224 224 224 224 224 224 224 224 224 224 224 185 184 224 224 224 224 224 224 224 224 224 224 224 224 224 224 0 0 0 0 0 0 0 0 0 0 
0 0 0 0 0 0 0 0 0 0 183 183 183 183 183 183 183 183 183 183 183 183 183 183 219 218 183 183 183 183 183 183 183 183 183 183 183 183 183 183 0 0 0 0 0 0 0 0 0 0 
0 0 0 0 0 0 0 0 0 0 182 182 182 182 182 182 182 182 182 182 182 182 182 182 216 217 182 182 182 182 182 182 182 182 182 182 182 182 182 182 0 0 0 0 0 0 0 0 0 0 
0 0 0 0 0 0 0 0 0 0 224 224 224 224 224 224 224 224 224 224 224 224 224 224 185 184 224 224 224 224 224 224 224 224 224 224 224 224 224 224 0 0 0 0 0 0 0 0 0 0 
0 0 0 0 0 0 0 0 0 0 175 175 175 175 175 175 175 175 175 175 175 175 175 224 185 184 224 175 175 175 175 175 175 175 175 175 175 175 175 175 0 0 0 0 0 0 0 0 0 0 
0 0 0 0 0 0 0 0 0 0 175 175 175 175 175 175 175 175 175 175 175 175 175 224 185 184 224 175 175 175 175 175 175 175 175 175 175 175 175 175 0 0 0 0 0 0 0 0 0 0 
0 0 0 0 0 0 0 0 0 0 175 175 175 175 175 175 175 175 175 175 175 175 175 224 185 184 224 175 175 175 175 175 175 175 175 175 175 175 175 175 0 0 0 0 0 0 0 0 0 0 
0 0 0 0 0 0 0 0 0 0 175 175 175 175 175 175 175 175 175 175 175 175 175 224 185 184 224 175 175 175 175 175 175 175 175 175 175 175 175 175 0 0 0 0 0 0 0 0 0 0 
0 0 0 0 0 0 0 0 0 0 175 175 175 175 175 175 175 175 175 175 175 175 175 224 185 184 224 175 175 175 175 175 175 175 175 175 175 175 175 175 0 0 0 0 0 0 0 0 0 0 
0 0 0 0 0 0 0 0 0 0 175 175 175 175 175 175 175 175 175 175 175 175 175 224 185 184 224 175 175 175 175 175 175 175 175 175 175 175 175 175 0 0 0 0 0 0 0 0 0 0 
0 0 0 0 0 0 0 0 0 0 175 175 175 175 175 175 175 175 175 175 175 175 175 224 185 184 224 175 175 175 175 175 175 175 175 175 175 175 175 175 0 0 0 0 0 0 0 0 0 0 
0 0 0 0 0 0 0 0 0 0 175 175 175 175 175 175 175 175 175 175 175 175 175 224 185 184 224 175 175 175 175 175 175 175 175 175 175 175 175 175 0 0 0 0 0 0 0 0 0 0 
0 0 0 0 0 0 0 0 0 0 175 175 175 175 175 175 175 175 175 175 175 175 175 224 185 184 224 175 175 175 175 175 175 175 175 175 175 175 175 175 0 0 0 0 0 0 0 0 0 0 
0 0 0 0 0 0 0 0 0 0 175 175 175 175 175 175 175 175 175 175 175 175 175 224 185 184 224 175 175 175 175 175 175 175 175 175 175 175 175 175 0 0 0 0 0 0 0 0 0 0 
0 0 0 0 0 0 0 0 0 0 175 175 175 175 175 175 175 175 175 175 175 175 175 224 185 184 224 175 175 175 175 175 175 175 175 175 175 175 175 175 0 0 0 0 0 0 0 0 0 0 
0 0 0 0 0 0 0 0 0 0 175 175 175 175 175 175 175 175 175 175 175 175 175 224 223 222 224 175 175 175 175 175 175 175 175 175 175 175 175 175 0 0 0 0 0 0 0 0 0 0 
0 0 0 0 0 0 0 0 0 0 175 175 175 175 175 175 175 175 175 175 175 175 175 224 224 224 224 175 175 175 175 175 175 175 175 175 175 175 175 175 0 0 0 0 0 0 0 0 0 0 
0 0 0 0 0 0 0 0 0 0 175 175 175 175 175 175 175 175 175 175 175 175 175 175 175 175 175 175 175 175 175 175 175 175 175 175 175 175 175 175 0 0 0 0 0 0 0 0 0 0 
0 0 0 0 0 0 0 0 0 0 175 175 175 175 175 175 175 175 175 175 175 175 175 175 175 175 175 175 175 175 175 175 175 175 175 175 175 175 175 175 0 0 0 0 0 0 0 0 0 0 
0 0 0 0 0 0 0 0 0 0 175 175 175 175 175 175 175 175 175 175 175 175 175 175 175 175 175 175 175 175 175 175 175 175 175 175 175 175 175 175 0 0 0 0 0 0 0 0 0 0 
0 0 0 0 0 0 0 0 0 0 175 175 175 175 175 175 175 175 175 175 175 175 175 175 175 175 175 175 175 175 175 175 175 175 175 175 175 175 175 175 0 0 0 0 0 0 0 0 0 0 
0 0 0 0 0 0 0 0 0 0 175 175 175 175 175 175 175 175 175 175 175 175 175 175 175 175 175 175 175 175 175 175 175 175 175 175 175 175 175 175 0 0 0 0 0 0 0 0 0 0 
0 0 0 0 0 0 0 0 0 0 0 0 0 0 0 0 0 0 0 0 0 0 0 0 0 0 0 0 0 0 0 0 0 0 0 0 0 0 0 0 0 0 0 0 0 0 0 0 0 0 
0 0 0 0 0 0 0 0 0 0 0 0 0 0 0 0 0 0 0 0 0 0 0 0 0 0 0 0 0 0 0 0 0 0 0 0 0 0 0 0 0 0 0 0 0 0 0 0 0 0 
0 0 0 0 0 0 0 0 0 0 0 0 0 0 0 0 0 0 0 0 0 0 0 0 0 0 0 0 0 0 0 0 0 0 0 0 0 0 0 0 0 0 0 0 0 0 0 0 0 0 
0 0 0 0 0 0 0 0 0 0 0 0 0 0 0 0 0 0 0 0 0 0 0 0 0 0 0 0 0 0 0 0 0 0 0 0 0 0 0 0 0 0 0 0 0 0 0 0 0 0 
