0 0 0 0 0 0 0 0 0 0 0 0 0 0 0 0 0 0 0 0 0 0 0 0 0 0 0 0 0 0 0 0 0 0 0 0 0 0 0 0 0 0 0 0 0 0 0 0 0 0 
0 0 0 0 0 0 0 0 0 0 0 0 0 0 0 0 0 0 0 0 0 0 0 0 0 0 0 0 0 0 0 0 0 0 0 0 0 0 0 0 0 0 0 0 0 0 0 0 0 0 
0 0 0 0 0 0 0 0 0 0 0 0 0 0 0 0 0 0 0 0 0 0 0 0 0 0 0 0 0 0 0 0 0 0 0 0 0 0 0 0 0 0 0 0 0 0 0 0 0 0 
0 0 0 0 0 0 0 0 0 0 0 0 0 0 0 0 0 0 0 0 0 0 0 0 0 0 0 0 0 0 0 0 0 0 0 0 0 0 0 0 0 0 0 0 0 0 0 0 0 0 
0 0 0 0 0 0 0 0 0 0 0 0 0 0 0 0 0 0 0 0 0 0 0 0 0 0 0 0 0 0 0 0 0 0 0 0 0 0 0 0 0 0 0 0 0 0 0 0 0 0 
0 0 0 0 0 0 0 0 0 0 0 0 0 0 0 0 0 0 0 0 0 0 0 0 0 0 0 0 0 0 0 0 0 0 0 0 0 0 0 0 0 0 0 0 0 0 0 0 0 0 
0 0 0 0 0 0 0 0 0 0 0 0 0 0 0 0 0 0 0 0 0 0 0 0 0 0 0 0 0 0 0 0 0 0 0 0 0 0 0 0 0 0 0 0 0 0 0 0 0 0 
0 0 0 0 0 0 0 0 0 0 0 0 0 0 0 0 0 0 0 0 0 0 0 0 0 0 0 0 0 0 0 0 0 0 0 0 0 0 0 0 0 0 0 0 0 0 0 0 0 0 
0 0 0 0 0 0 0 0 0 0 0 0 0 0 0 0 0 0 0 0 0 0 0 0 0 0 0 0 0 0 0 0 0 0 0 0 0 0 0 0 0 0 0 0 0 0 0 0 0 0 
0 0 0 0 0 0 0 0 0 0 0 0 0 0 0 0 0 0 0 0 0 0 0 0 0 0 0 0 0 0 0 0 0 0 0 0 0 0 0 0 0 0 0 0 0 0 0 0 0 0 
0 0 0 0 0 0 0 0 0 0 0 0 0 0 0 0 0 0 0 0 0 0 0 0 0 0 0 0 0 0 0 0 0 0 0 0 0 0 0 0 0 0 0 0 0 0 0 0 0 0 
0 0 0 0 0 0 0 0 0 0 0 0 0 0 0 0 0 0 0 0 0 0 0 0 0 0 0 0 0 0 0 0 0 0 0 0 0 0 0 0 0 0 0 0 0 0 0 0 0 0 
0 0 0 0 0 0 0 0 0 0 0 0 0 0 0 0 0 0 0 0 0 0 0 0 0 0 0 0 0 0 0 0 0 0 0 0 0 0 0 0 0 0 0 0 0 0 0 0 0 0 
0 0 0 0 0 0 0 0 0 0 0 0 0 0 0 0 0 0 0 0 0 0 0 0 0 0 0 0 0 0 0 0 0 0 0 0 0 0 0 0 0 0 0 0 0 0 0 0 0 0 
0 0 0 0 0 0 0 0 0 0 0 0 0 0 0 0 0 0 0 0 0 0 0 0 0 0 0 0 0 0 0 0 0 0 0 0 0 0 0 0 0 0 0 0 0 0 0 0 0 0 
0 0 0 0 0 0 0 0 0 0 0 0 0 0 0 0 0 0 0 0 0 0 0 0 0 0 0 0 0 0 0 0 0 0 0 0 0 0 0 0 0 0 0 0 0 0 0 0 0 0 
0 0 0 0 0 0 0 0 0 0 0 0 0 0 0 0 0 0 0 0 0 0 0 0 0 0 0 0 0 0 0 0 0 0 0 0 0 0 0 0 0 0 0 0 0 0 0 0 0 0 
0 0 0 0 0 0 0 0 0 0 297 299 297 299 224 228 297 299 297 299 297 299 297 299 297 299 318 311 323 311 319 311 323 311 322 297 299 297 299 297 299 0 0 0 0 0 0 0 0 0 
0 0 0 0 0 0 0 0 0 0 298 300 217 221 225 229 298 300 298 300 298 300 298 300 298 300 285 311 324 311 319 311 324 311 287 298 300 232 235 237 300 0 0 0 0 0 0 0 0 0 
0 0 0 0 0 0 0 0 0 0 297 299 218 222 226 230 297 299 240 242 244 299 297 299 297 299 286 311 323 311 319 311 323 311 288 297 299 233 236 238 299 0 0 0 0 0 0 0 0 0 
0 0 0 0 0 0 0 0 0 0 298 300 219 223 227 231 298 300 241 243 245 300 298 300 298 300 318 250 253 256 319 311 324 311 322 298 300 234 300 239 300 0 0 0 0 0 0 0 0 0 
0 0 0 0 0 0 0 0 0 0 297 299 297 299 297 299 151 159 167 175 183 307 246 248 297 299 318 251 254 257 319 294 323 311 322 151 159 167 175 183 309 0 0 0 0 0 0 0 0 0 
0 0 0 0 0 0 0 0 0 0 117 124 131 137 144 304 152 160 168 176 184 304 247 249 298 300 318 252 255 258 319 311 324 311 322 152 160 168 176 184 304 0 0 0 0 0 0 0 0 0 
0 0 0 0 0 0 0 0 0 0 118 125 132 138 145 303 153 161 169 177 185 303 301 307 297 299 318 311 323 311 319 311 323 311 322 153 161 169 177 185 303 0 0 0 0 0 0 0 0 0 
0 0 0 0 0 0 0 0 0 0 119 126 133 139 146 304 154 162 170 178 186 191 196 201 206 211 318 311 324 311 319 311 324 311 322 154 162 170 178 186 304 0 0 0 0 0 0 0 0 0 
0 0 0 0 0 0 0 0 0 0 120 127 134 140 147 311 155 163 171 179 187 192 197 202 207 212 318 311 323 311 319 311 323 311 322 155 163 171 179 187 303 0 0 0 0 0 0 0 0 0 
0 0 0 0 0 0 0 0 0 0 121 128 135 141 148 311 156 164 172 180 188 193 198 203 208 213 318 311 324 311 319 311 324 311 322 156 164 172 180 188 304 0 0 0 0 0 0 0 0 0 
0 0 0 0 0 0 0 0 0 0 122 129 136 142 149 311 157 165 173 181 189 194 199 204 209 214 318 311 311 311 319 291 291 291 322 157 165 173 181 189 303 0 0 0 0 0 0 0 0 0 
0 0 0 0 0 0 0 0 0 0 123 130 132 143 150 305 158 166 174 182 190 195 200 205 210 215 318 331 333 335 320 331 333 335 322 158 166 174 182 190 304 0 0 0 0 0 0 0 0 0 
0 0 0 0 0 0 0 0 0 0 316 316 316 316 316 306 292 312 312 312 312 312 312 312 312 312 314 332 334 336 321 332 334 336 315 316 316 316 316 316 316 0 0 0 0 0 0 0 0 0 
0 0 0 0 0 0 0 0 0 0 311 311 311 311 311 311 311 311 265 311 311 311 311 311 311 325 328 311 311 311 311 311 311 311 325 328 311 311 311 311 311 0 0 0 0 0 0 0 0 0 
0 0 0 0 0 0 0 0 0 0 282 296 295 296 295 296 295 296 266 268 270 296 293 296 311 326 329 272 275 278 311 294 311 311 259 261 263 295 296 295 289 0 0 0 0 0 0 0 0 0 
0 0 0 0 0 0 0 0 0 0 283 311 311 311 311 311 311 311 311 269 271 311 311 311 311 327 330 273 276 279 280 311 311 311 260 262 264 311 311 311 290 0 0 0 0 0 0 0 0 0 
0 0 0 0 0 0 0 0 0 0 284 313 313 313 313 313 313 313 313 313 284 313 313 313 313 313 313 274 277 277 281 317 317 317 317 317 317 317 317 317 308 0 0 0 0 0 0 0 0 0 
0 0 0 0 0 0 0 0 0 0 0 0 0 0 0 0 0 0 0 0 0 0 0 0 0 0 0 0 0 0 0 0 0 0 0 0 0 0 0 0 0 0 0 0 0 0 0 0 0 0 
0 0 0 0 0 0 0 0 0 0 0 0 0 0 0 0 0 0 0 0 0 0 0 0 0 0 0 0 0 0 0 0 0 0 0 0 0 0 0 0 0 0 0 0 0 0 0 0 0 0 
0 0 0 0 0 0 0 0 0 0 0 0 0 0 0 0 0 0 0 0 0 0 0 0 0 0 0 0 0 0 0 0 0 0 0 0 0 0 0 0 0 0 0 0 0 0 0 0 0 0 
0 0 0 0 0 0 0 0 0 0 0 0 0 0 0 0 0 0 0 0 0 0 0 0 0 0 0 0 0 0 0 0 0 0 0 0 0 0 0 0 0 0 0 0 0 0 0 0 0 0 
0 0 0 0 0 0 0 0 0 0 0 0 0 0 0 0 0 0 0 0 0 0 0 0 0 0 0 0 0 0 0 0 0 0 0 0 0 0 0 0 0 0 0 0 0 0 0 0 0 0 
0 0 0 0 0 0 0 0 0 0 0 0 0 0 0 0 0 0 0 0 0 0 0 0 0 0 0 0 0 0 0 0 0 0 0 0 0 0 0 0 0 0 0 0 0 0 0 0 0 0 
0 0 0 0 0 0 0 0 0 0 0 0 0 0 0 0 0 0 0 0 0 0 0 0 0 0 0 0 0 0 0 0 0 0 0 0 0 0 0 0 0 0 0 0 0 0 0 0 0 0 
0 0 0 0 0 0 0 0 0 0 0 0 0 0 0 0 0 0 0 0 0 0 0 0 0 0 0 0 0 0 0 0 0 0 0 0 0 0 0 0 0 0 0 0 0 0 0 0 0 0 
0 0 0 0 0 0 0 0 0 0 0 0 0 0 0 0 0 0 0 0 0 0 0 0 0 0 0 0 0 0 0 0 0 0 0 0 0 0 0 0 0 0 0 0 0 0 0 0 0 0 
0 0 0 0 0 0 0 0 0 0 0 0 0 0 0 0 0 0 0 0 0 0 0 0 0 0 0 0 0 0 0 0 0 0 0 0 0 0 0 0 0 0 0 0 0 0 0 0 0 0 
0 0 0 0 0 0 0 0 0 0 0 0 0 0 0 0 0 0 0 0 0 0 0 0 0 0 0 0 0 0 0 0 0 0 0 0 0 0 0 0 0 0 0 0 0 0 0 0 0 0 
0 0 0 0 0 0 0 0 0 0 0 0 0 0 0 0 0 0 0 0 0 0 0 0 0 0 0 0 0 0 0 0 0 0 0 0 0 0 0 0 0 0 0 0 0 0 0 0 0 0 
0 0 0 0 0 0 0 0 0 0 0 0 0 0 0 0 0 0 0 0 0 0 0 0 0 0 0 0 0 0 0 0 0 0 0 0 0 0 0 0 0 0 0 0 0 0 0 0 0 0 
0 0 0 0 0 0 0 0 0 0 0 0 0 0 0 0 0 0 0 0 0 0 0 0 0 0 0 0 0 0 0 0 0 0 0 0 0 0 0 0 0 0 0 0 0 0 0 0 0 0 
0 0 0 0 0 0 0 0 0 0 0 0 0 0 0 0 0 0 0 0 0 0 0 0 0 0 0 0 0 0 0 0 0 0 0 0 0 0 0 0 0 0 0 0 0 0 0 0 0 0 
0 0 0 0 0 0 0 0 0 0 0 0 0 0 0 0 0 0 0 0 0 0 0 0 0 0 0 0 0 0 0 0 0 0 0 0 0 0 0 0 0 0 0 0 0 0 0 0 0 0 
